1background
1
/data/image/background2

2music
1
/data/music/music2

3snake
3
10 7
9 7
9 8

4stone
0

5button
2
8 12 Short
12 22 Spike
3
11 21
8 22
8 20

6map
24 39

-1	-1	-1	-1	-1	-1	-1	-1	-1	-1	-1	-1	-1	-1	-1	-1	-1	-1	-1	-1	-1	-1	-1	-1	-1	-1	-1	-1	-1	-1	-1	-1	-1	-1	-1	-1	-1	-1	-1
-1	-1	-1	-1	-1	-1	-1	-1	-1	-1	-1	-1	-1	-1	-1	-1	-1	-1	-1	-1	-1	-1	-1	-1	-1	-1	-1	-1	-1	-1	-1	-1	-1	-1	-1	-1	-1	-1	-1
-1	-1	0	0	0	0	0	0	0	0	0	0	0	0	0	0	0	0	0	0	0	0	0	0	0	0	0	0	0	0	0	0	0	0	0	0	0	-1	-1
-1	-1	0	0	0	0	0	0	0	0	0	0	0	0	0	0	0	0	0	0	0	0	0	0	0	0	0	0	0	0	0	0	0	0	0	0	0	-1	-1
-1	-1	0	0	0	0	0	0	0	0	0	0	0	0	0	0	0	0	0	0	0	0	0	0	0	0	0	0	0	0	0	0	0	0	0	0	0	-1	-1
-1	-1	0	0	0	0	0	0	0	0	0	0	0	0	0	0	0	0	0	0	0	0	0	0	0	0	0	0	0	0	0	0	0	0	0	0	0	-1	-1
-1	-1	0	0	0	0	0	0	0	0	0	0	0	0	0	0	0	0	0	0	0	0	0	0	0	0	0	0	0	0	0	0	0	0	0	0	0	-1	-1
-1	-1	0	0	0	0	0	0	0	0	0	0	0	0	0	0	0	0	0	0	0	0	0	0	0	0	0	0	0	0	0	0	0	0	0	0	0	-1	-1
-1	-1	0	0	0	0	0	0	0	0	0	1	8	0	0	0	0	0	0	0	0	0	0	0	0	0	0	0	0	0	0	0	0	0	0	0	0	-1	-1
-1	-1	0	0	0	0	0	3	2	0	0	1	1	0	0	0	7	0	0	5	1	0	1	1	1	1	1	1	0	0	0	0	0	0	0	0	0	-1	-1
-1	-1	0	0	0	0	0	3	1	1	0	1	1	0	1	0	1	0	0	0	0	0	1	0	0	1	1	1	0	0	0	0	0	0	0	0	0	-1	-1
-1	-1	0	0	0	0	0	0	1	0	0	1	0	0	1	0	1	1	0	0	1	7	0	0	0	0	1	1	0	0	0	0	0	0	0	0	0	-1	-1
-1	-1	0	0	0	0	0	0	1	0	0	0	0	0	1	0	0	0	0	7	1	1	8	5	1	0	7	0	0	7	0	0	0	0	0	0	0	-1	-1
-1	-1	0	0	0	0	0	0	1	0	5	1	1	1	1	0	1	1	1	1	1	1	1	0	1	0	0	0	1	1	0	4	0	0	0	0	0	-1	-1
-1	-1	0	0	0	0	0	0	1	1	0	0	0	0	1	0	1	0	0	0	0	0	1	1	1	1	0	0	1	1	1	1	0	0	0	0	0	-1	-1
-1	-1	0	0	0	0	0	0	0	0	0	0	0	0	1	1	1	0	0	0	0	0	0	0	0	1	1	1	1	1	0	0	0	0	0	0	0	-1	-1
-1	-1	0	0	0	0	0	0	0	0	0	0	0	0	0	0	0	0	0	0	0	0	0	0	0	0	0	0	0	0	0	0	0	0	0	0	0	-1	-1
-1	-1	0	0	0	0	0	0	0	0	0	0	0	0	0	0	0	0	0	0	0	0	0	0	0	0	0	0	0	0	0	0	0	0	0	0	0	-1	-1
-1	-1	0	0	0	0	0	0	0	0	0	0	0	0	0	0	0	0	0	0	0	0	0	0	0	0	0	0	0	0	0	0	0	0	0	0	0	-1	-1
-1	-1	0	0	0	0	0	0	0	0	0	0	0	0	0	0	0	0	0	0	0	0	0	0	0	0	0	0	0	0	0	0	0	0	0	0	0	-1	-1
-1	-1	0	0	0	0	0	0	0	0	0	0	0	0	0	0	0	0	0	0	0	0	0	0	0	0	0	0	0	0	0	0	0	0	0	0	0	-1	-1
-1	-1	0	0	0	0	0	0	0	0	0	0	0	0	0	0	0	0	0	0	0	0	0	0	0	0	0	0	0	0	0	0	0	0	0	0	0	-1	-1
-1	-1	-1	-1	-1	-1	-1	-1	-1	-1	-1	-1	-1	-1	-1	-1	-1	-1	-1	-1	-1	-1	-1	-1	-1	-1	-1	-1	-1	-1	-1	-1	-1	-1	-1	-1	-1	-1	-1
-1	-1	-1	-1	-1	-1	-1	-1	-1	-1	-1	-1	-1	-1	-1	-1	-1	-1	-1	-1	-1	-1	-1	-1	-1	-1	-1	-1	-1	-1	-1	-1	-1	-1	-1	-1	-1	-1	-1
▞▞▞▞▞▞▞▞▞▞▞▞▞▞▞▞▞▞▞▞▞▞▞▞▞▞▞▞▞▞▞▞▞▞▞▞▞▞▞▞▞▞▞▞▞▞▞▞▞▞▞▞▞▞▞▞▞▞▞▞▞▞▞▞▞▞▞▞▞▞▞▞▞▞▞▞▞▞
▞▞▞▞▞▞▞▞▞▞▞▞▞▞▞▞▞▞▞▞▞▞▞▞▞▞▞▞▞▞▞▞▞▞▞▞▞▞▞▞▞▞▞▞▞▞▞▞▞▞▞▞▞▞▞▞▞▞▞▞▞▞▞▞▞▞▞▞▞▞▞▞▞▞▞▞▞▞
▞▞▞▞                                                                      ▞▞▞▞
▞▞▞▞                                                                      ▞▞▞▞
▞▞▞▞                                                                      ▞▞▞▞
▞▞▞▞                                                                      ▞▞▞▞
▞▞▞▞                                                                      ▞▞▞▞
▞▞▞▞                                                                      ▞▞▞▞
▞▞▞▞                  ██ ▂                                                ▞▞▞▞
▞▞▞▞          ▒▒▓▓    ████      ||     ⋄██  ████████████                  ▞▞▞▞
▞▞▞▞          ▒▒████  ████  ██  ██          ██    ██████                  ▞▞▞▞
▞▞▞▞            ██    ██    ██  ████    ██||        ████                  ▞▞▞▞
▞▞▞▞            ██          ██        ||████ ▂ ⋄██  ||    ||              ▞▞▞▞
▞▞▞▞            ██   ⋄████████  ██████████████  ██      ████   ⊠          ▞▞▞▞
▞▞▞▞            ████        ██  ██          ████████    ████████          ▞▞▞▞
▞▞▞▞                        ██████                ██████████              ▞▞▞▞
▞▞▞▞                                                                      ▞▞▞▞
▞▞▞▞                                                                      ▞▞▞▞
▞▞▞▞                                                                      ▞▞▞▞
▞▞▞▞                                                                      ▞▞▞▞
▞▞▞▞                                                                      ▞▞▞▞
▞▞▞▞                                                                      ▞▞▞▞
▞▞▞▞▞▞▞▞▞▞▞▞▞▞▞▞▞▞▞▞▞▞▞▞▞▞▞▞▞▞▞▞▞▞▞▞▞▞▞▞▞▞▞▞▞▞▞▞▞▞▞▞▞▞▞▞▞▞▞▞▞▞▞▞▞▞▞▞▞▞▞▞▞▞▞▞▞▞
▞▞▞▞▞▞▞▞▞▞▞▞▞▞▞▞▞▞▞▞▞▞▞▞▞▞▞▞▞▞▞▞▞▞▞▞▞▞▞▞▞▞▞▞▞▞▞▞▞▞▞▞▞▞▞▞▞▞▞▞▞▞▞▞▞▞▞▞▞▞▞▞▞▞▞▞▞▞
