1background
1
/data/image/background3

2music
1
/data/music/music3

3snake
4
11 8
12 8
12 9
12 10

4stone
0

5button
0

6map
24 39

-1	-1	-1	-1	-1	-1	-1	-1	-1	-1	-1	-1	-1	-1	-1	-1	-1	-1	-1	-1	-1	-1	-1	-1	-1	-1	-1	-1	-1	-1	-1	-1	-1	-1	-1	-1	-1	-1	-1
-1	-1	-1	-1	-1	-1	-1	-1	-1	-1	-1	-1	-1	-1	-1	-1	-1	-1	-1	-1	-1	-1	-1	-1	-1	-1	-1	-1	-1	-1	-1	-1	-1	-1	-1	-1	-1	-1	-1
-1	-1	0	0	0	0	0	0	0	0	0	0	0	0	0	0	0	0	0	0	0	0	0	0	0	0	0	0	0	0	0	0	0	0	0	0	0	-1	-1
-1	-1	0	0	0	0	0	0	0	0	0	0	0	0	0	0	0	0	0	0	0	0	0	0	0	0	0	0	0	0	0	0	0	0	0	0	0	-1	-1
-1	-1	0	0	0	0	0	0	0	0	0	0	0	0	0	0	0	0	0	0	0	0	0	0	0	0	0	0	0	0	0	0	0	0	0	0	0	-1	-1
-1	-1	0	0	0	0	0	0	0	0	0	0	0	0	0	0	0	0	0	0	0	0	0	0	0	0	0	0	0	0	0	0	0	0	0	0	0	-1	-1
-1	-1	0	0	0	0	0	0	0	0	0	0	0	0	0	0	0	0	0	0	0	0	0	0	0	0	0	0	0	0	0	0	0	0	0	0	0	-1	-1
-1	-1	0	0	0	0	0	0	0	0	0	0	0	0	0	0	0	0	0	0	0	0	0	0	0	0	0	0	0	0	0	0	0	0	0	0	0	-1	-1
-1	-1	0	0	0	0	0	0	0	0	5	0	0	0	0	0	0	0	0	0	0	0	0	0	0	0	0	0	0	0	0	0	0	0	0	0	0	-1	-1
-1	-1	0	0	0	0	0	0	0	0	1	0	0	0	0	0	0	0	0	0	0	0	0	0	0	0	0	0	0	0	0	0	0	0	0	0	0	-1	-1
-1	-1	0	0	0	0	0	0	0	0	1	0	0	0	0	0	0	0	0	0	0	0	0	0	0	0	0	0	0	0	0	0	0	0	0	0	0	-1	-1
-1	-1	0	0	0	0	0	0	3	0	0	0	0	0	0	0	0	0	0	0	0	0	0	0	0	0	0	0	0	0	0	0	0	0	0	0	0	-1	-1
-1	-1	0	0	0	0	0	0	3	4	2	0	0	0	0	0	0	0	0	0	0	0	0	0	0	0	0	0	0	0	0	0	0	0	0	0	0	-1	-1
-1	-1	0	0	0	0	0	0	0	1	0	0	0	0	0	0	0	0	0	0	0	0	0	0	0	0	0	0	0	0	0	0	0	0	0	0	0	-1	-1
-1	-1	0	0	0	0	0	0	0	0	0	0	0	0	0	0	0	0	0	0	0	0	0	0	0	0	0	0	0	0	0	0	0	0	0	0	0	-1	-1
-1	-1	0	0	0	0	0	0	0	0	0	0	0	0	0	0	0	0	0	0	0	0	0	0	0	0	0	0	0	0	0	0	0	0	0	0	0	-1	-1
-1	-1	0	0	0	0	0	0	0	0	0	0	0	0	0	0	0	0	0	0	0	0	0	0	0	0	0	0	0	0	0	0	0	0	0	0	0	-1	-1
-1	-1	0	0	0	0	0	0	0	0	0	0	0	0	0	0	0	0	0	0	0	0	0	0	0	0	0	0	0	0	0	0	0	0	0	0	0	-1	-1
-1	-1	0	0	0	0	0	0	0	0	0	0	0	0	0	0	0	0	0	0	0	0	0	0	0	0	0	0	0	0	0	0	0	0	0	0	0	-1	-1
-1	-1	0	0	0	0	0	0	0	0	0	0	0	0	0	0	0	0	0	0	0	0	0	0	0	0	0	0	0	0	0	0	0	0	0	0	0	-1	-1
-1	-1	0	0	0	0	0	0	0	0	0	0	0	0	0	0	0	0	0	0	0	0	0	0	0	0	0	0	0	0	0	0	0	0	0	0	0	-1	-1
-1	-1	0	0	0	0	0	0	0	0	0	0	0	0	0	0	0	0	0	0	0	0	0	0	0	0	0	0	0	0	0	0	0	0	0	0	0	-1	-1
-1	-1	-1	-1	-1	-1	-1	-1	-1	-1	-1	-1	-1	-1	-1	-1	-1	-1	-1	-1	-1	-1	-1	-1	-1	-1	-1	-1	-1	-1	-1	-1	-1	-1	-1	-1	-1	-1	-1
-1	-1	-1	-1	-1	-1	-1	-1	-1	-1	-1	-1	-1	-1	-1	-1	-1	-1	-1	-1	-1	-1	-1	-1	-1	-1	-1	-1	-1	-1	-1	-1	-1	-1	-1	-1	-1	-1	-1
▞▞▞▞▞▞▞▞▞▞▞▞▞▞▞▞▞▞▞▞▞▞▞▞▞▞▞▞▞▞▞▞▞▞▞▞▞▞▞▞▞▞▞▞▞▞▞▞▞▞▞▞▞▞▞▞▞▞▞▞▞▞▞▞▞▞▞▞▞▞▞▞▞▞▞▞▞▞
▞▞▞▞▞▞▞▞▞▞▞▞▞▞▞▞▞▞▞▞▞▞▞▞▞▞▞▞▞▞▞▞▞▞▞▞▞▞▞▞▞▞▞▞▞▞▞▞▞▞▞▞▞▞▞▞▞▞▞▞▞▞▞▞▞▞▞▞▞▞▞▞▞▞▞▞▞▞
▞▞▞▞                                                                      ▞▞▞▞
▞▞▞▞                                                                      ▞▞▞▞
▞▞▞▞                                                                      ▞▞▞▞
▞▞▞▞                                                                      ▞▞▞▞
▞▞▞▞                                                                      ▞▞▞▞
▞▞▞▞                                                                      ▞▞▞▞
▞▞▞▞                 ⋄                                                    ▞▞▞▞
▞▞▞▞                ██                                                    ▞▞▞▞
▞▞▞▞                ██                                                    ▞▞▞▞
▞▞▞▞            ▒▒                                                        ▞▞▞▞
▞▞▞▞            ▒▒ ⊠▓▓                                                    ▞▞▞▞
▞▞▞▞              ██                                                      ▞▞▞▞
▞▞▞▞                                                                      ▞▞▞▞
▞▞▞▞                                                                      ▞▞▞▞
▞▞▞▞                                                                      ▞▞▞▞
▞▞▞▞                                                                      ▞▞▞▞
▞▞▞▞                                                                      ▞▞▞▞
▞▞▞▞                                                                      ▞▞▞▞
▞▞▞▞                                                                      ▞▞▞▞
▞▞▞▞                                                                      ▞▞▞▞
▞▞▞▞▞▞▞▞▞▞▞▞▞▞▞▞▞▞▞▞▞▞▞▞▞▞▞▞▞▞▞▞▞▞▞▞▞▞▞▞▞▞▞▞▞▞▞▞▞▞▞▞▞▞▞▞▞▞▞▞▞▞▞▞▞▞▞▞▞▞▞▞▞▞▞▞▞▞
▞▞▞▞▞▞▞▞▞▞▞▞▞▞▞▞▞▞▞▞▞▞▞▞▞▞▞▞▞▞▞▞▞▞▞▞▞▞▞▞▞▞▞▞▞▞▞▞▞▞▞▞▞▞▞▞▞▞▞▞▞▞▞▞▞▞▞▞▞▞▞▞▞▞▞▞▞▞
