1background
1
/data/image/background3

2music
1
/data/music/music3

3snake
4
10 14
11 14
11 13
10 13

4stone
1
11 22

5button
2
13 19 Short
15 29 Grave

6map
24 39

-1	-1	-1	-1	-1	-1	-1	-1	-1	-1	-1	-1	-1	-1	-1	-1	-1	-1	-1	-1	-1	-1	-1	-1	-1	-1	-1	-1	-1	-1	-1	-1	-1	-1	-1	-1	-1	-1	-1
-1	-1	-1	-1	-1	-1	-1	-1	-1	-1	-1	-1	-1	-1	-1	-1	-1	-1	-1	-1	-1	-1	-1	-1	-1	-1	-1	-1	-1	-1	-1	-1	-1	-1	-1	-1	-1	-1	-1
-1	-1	0	0	0	0	0	0	0	0	0	0	0	0	0	0	0	0	0	0	0	0	0	0	0	0	0	0	0	0	0	0	0	0	0	0	0	-1	-1
-1	-1	0	0	0	0	0	0	0	0	0	0	0	0	0	0	0	0	0	0	0	0	0	0	0	0	0	0	0	0	0	0	0	0	0	0	0	-1	-1
-1	-1	0	0	0	0	0	0	0	0	0	0	0	0	0	0	0	0	0	0	0	0	0	0	0	0	0	0	0	0	0	0	0	0	0	0	0	-1	-1
-1	-1	0	0	0	0	0	0	0	0	0	0	0	0	0	0	0	0	0	0	0	0	0	0	0	0	0	0	0	0	0	0	0	0	0	0	0	-1	-1
-1	-1	0	0	0	0	0	0	0	0	0	0	0	0	0	0	0	0	0	0	0	0	0	0	0	0	0	0	0	0	0	0	0	0	0	0	0	-1	-1
-1	-1	0	0	0	0	0	0	0	0	0	0	0	0	0	0	0	0	0	0	0	0	0	0	0	0	0	0	0	0	0	0	0	0	0	0	0	-1	-1
-1	-1	0	0	0	0	0	0	0	0	0	0	0	0	0	0	0	0	0	0	0	0	0	0	1	1	0	0	0	0	0	0	0	0	0	0	0	-1	-1
-1	-1	0	0	0	0	0	1	1	0	0	0	0	0	0	0	0	0	0	7	0	0	0	0	7	0	0	1	0	0	0	0	0	0	0	0	0	-1	-1
-1	-1	0	0	0	0	0	0	1	1	0	0	0	2	3	0	0	0	0	1	0	0	0	0	0	0	0	0	0	0	0	0	0	0	0	0	0	-1	-1
-1	-1	0	0	0	0	0	5	0	0	0	0	0	3	3	0	0	0	0	1	0	0	6	0	0	0	0	0	0	0	0	4	0	0	0	0	0	-1	-1
-1	-1	0	0	0	0	0	0	0	0	0	0	0	1	1	0	0	0	0	1	0	0	1	1	0	0	0	0	0	0	0	1	0	0	0	0	0	-1	-1
-1	-1	0	0	0	0	0	0	1	0	0	7	0	0	0	0	0	7	0	8	0	0	0	0	0	0	0	0	0	0	0	0	0	0	0	0	0	-1	-1
-1	-1	0	0	0	0	0	0	1	0	0	1	0	1	0	0	0	1	1	1	1	1	0	0	0	0	0	0	0	0	0	0	0	0	0	0	0	-1	-1
-1	-1	0	0	0	0	0	0	1	1	0	0	0	0	0	0	0	0	1	0	0	0	0	0	0	0	0	0	0	8	0	1	0	0	0	0	0	-1	-1
-1	-1	0	0	0	0	0	0	1	1	1	0	0	0	1	0	0	0	0	0	0	0	0	0	1	1	1	1	1	1	0	0	0	0	0	0	0	-1	-1
-1	-1	0	0	0	0	0	0	0	0	0	0	0	0	0	0	0	0	0	0	0	0	0	0	0	0	0	0	0	0	0	0	0	0	0	0	0	-1	-1
-1	-1	0	0	0	0	0	0	0	0	0	0	0	0	0	0	0	0	0	0	0	0	0	0	0	0	0	0	0	0	0	0	0	0	0	0	0	-1	-1
-1	-1	0	0	0	0	0	0	0	0	0	0	0	0	0	0	0	0	0	0	0	0	0	0	0	0	0	0	0	0	0	0	0	0	0	0	0	-1	-1
-1	-1	0	0	0	0	0	0	0	0	0	0	0	0	0	0	0	0	0	0	0	0	0	0	0	0	0	0	0	0	0	0	0	0	0	0	0	-1	-1
-1	-1	0	0	0	0	0	0	0	0	0	0	0	0	0	0	0	0	0	0	0	0	0	0	0	0	0	0	0	0	0	0	0	0	0	0	0	-1	-1
-1	-1	-1	-1	-1	-1	-1	-1	-1	-1	-1	-1	-1	-1	-1	-1	-1	-1	-1	-1	-1	-1	-1	-1	-1	-1	-1	-1	-1	-1	-1	-1	-1	-1	-1	-1	-1	-1	-1
-1	-1	-1	-1	-1	-1	-1	-1	-1	-1	-1	-1	-1	-1	-1	-1	-1	-1	-1	-1	-1	-1	-1	-1	-1	-1	-1	-1	-1	-1	-1	-1	-1	-1	-1	-1	-1	-1	-1
▞▞▞▞▞▞▞▞▞▞▞▞▞▞▞▞▞▞▞▞▞▞▞▞▞▞▞▞▞▞▞▞▞▞▞▞▞▞▞▞▞▞▞▞▞▞▞▞▞▞▞▞▞▞▞▞▞▞▞▞▞▞▞▞▞▞▞▞▞▞▞▞▞▞▞▞▞▞
▞▞▞▞▞▞▞▞▞▞▞▞▞▞▞▞▞▞▞▞▞▞▞▞▞▞▞▞▞▞▞▞▞▞▞▞▞▞▞▞▞▞▞▞▞▞▞▞▞▞▞▞▞▞▞▞▞▞▞▞▞▞▞▞▞▞▞▞▞▞▞▞▞▞▞▞▞▞
▞▞▞▞                                                                      ▞▞▞▞
▞▞▞▞                                                                      ▞▞▞▞
▞▞▞▞                                                                      ▞▞▞▞
▞▞▞▞                                                                      ▞▞▞▞
▞▞▞▞                                                                      ▞▞▞▞
▞▞▞▞                                                                      ▞▞▞▞
▞▞▞▞                                            ████                      ▞▞▞▞
▞▞▞▞          ████                    ||        ||    ██                  ▞▞▞▞
▞▞▞▞            ████      ▓▓▒▒        ██                                  ▞▞▞▞
▞▞▞▞           ⋄          ▒▒▒▒        ██    ░░                 ⊠          ▞▞▞▞
▞▞▞▞                      ████        ██    ████              ██          ▞▞▞▞
▞▞▞▞            ██    ||          ||   ▂                                  ▞▞▞▞
▞▞▞▞            ██    ██  ██      ██████████                              ▞▞▞▞
▞▞▞▞            ████                ██                     ▂  ██          ▞▞▞▞
▞▞▞▞            ██████      ██                  ████████████              ▞▞▞▞
▞▞▞▞                                                                      ▞▞▞▞
▞▞▞▞                                                                      ▞▞▞▞
▞▞▞▞                                                                      ▞▞▞▞
▞▞▞▞                                                                      ▞▞▞▞
▞▞▞▞                                                                      ▞▞▞▞
▞▞▞▞▞▞▞▞▞▞▞▞▞▞▞▞▞▞▞▞▞▞▞▞▞▞▞▞▞▞▞▞▞▞▞▞▞▞▞▞▞▞▞▞▞▞▞▞▞▞▞▞▞▞▞▞▞▞▞▞▞▞▞▞▞▞▞▞▞▞▞▞▞▞▞▞▞▞
▞▞▞▞▞▞▞▞▞▞▞▞▞▞▞▞▞▞▞▞▞▞▞▞▞▞▞▞▞▞▞▞▞▞▞▞▞▞▞▞▞▞▞▞▞▞▞▞▞▞▞▞▞▞▞▞▞▞▞▞▞▞▞▞▞▞▞▞▞▞▞▞▞▞▞▞▞▞
